9 9 9 9 9 9 9 9 9 9 9 9 9 9 9 9 9 9 9 9 9 9 9 9 9 9 9 9 9 9 9 9 9 9 9 9 9 9 9 9 9 9 9 9 9 9 9 9 9 9
8 8 8 8 8 8 8 8 8 8 8 8 8 8 8 8 8 8 8 8 8 8 8 8 8 8 8 8 8 8 8 8 8 8 8 8 8 8 8 8 8 8 8 8 8 8 8 8 8 8
0 0 0 7 0 0 0 6 7 7 7 7 0 7 0 0 0 0 0 0 9 0 0 0 0 0 0 0 0 0 0 0 0 0 0 0 0 0 0 0 0 0 0 0 0 0 0 0 0 9
0 7 0 0 6 0 6 0 0 0 0 0 0 0 6 0 6 0 0 7 8 0 0 0 0 0 0 0 0 0 0 0 0 0 0 0 0 0 0 0 0 0 0 0 0 0 0 0 0 8
0 0 0 0 0 0 0 0 0 0 0 0 0 0 0 0 0 6 7 0 0 9 0 0 0 0 0 0 0 0 0 0 0 0 0 0 7 7 7 7 7 0 0 0 0 0 0 0 0 9
21 21 21 21 21 21 21 21 21 21 21 21 21 21 21 21 21 21 21 21 0 8 0 0 0 6 6 7 7 0 0 0 0 0 0 0 0 0 0 0 0 0 0 0 0 0 0 0 0 8
0 0 0 0 0 0 21 21 0 0 0 0 0 0 21 0 0 0 0 0 0 0 0 0 0 0 0 0 0 0 0 0 0 6 6 7 0 0 0 0 0 0 0 0 0 0 0 0 0 9
0 0 0 0 10 10 11 10 10 10 10 10 10 0 21 0 0 0 0 0 0 0 0 0 0 0 0 0 0 0 0 6 6 7 0 0 0 0 0 0 0 0 0 0 0 0 0 0 0 8
0 0 0 0 10 10 11 10 10 10 10 10 10 0 21 0 0 0 0 0 0 10 10 10 10 10 0 0 0 0 0 0 0 0 0 6 6 6 6 0 0 0 0 0 0 0 0 0 0 9
0 0 0 0 19 13 11 10 10 10 10 10 10 0 21 0 0 0 0 0 0 10 11 11 11 10 0 0 0 0 0 0 0 0 0 0 6 6 0 0 0 0 0 0 0 0 0 0 0 8
0 0 0 0 11 11 11 10 10 10 10 10 10 0 3 3 3 3 3 3 3 10 11 20 11 10 0 0 0 0 0 0 0 0 0 0 0 0 0 0 0 0 0 0 0 0 0 0 0 9
0 0 0 0 17 17 11 10 10 10 10 10 10 0 5 1 1 1 1 1 1 2 0 10 10 10 0 0 0 0 0 0 0 0 0 0 0 0 0 0 0 0 0 0 0 0 0 0 0 8
0 0 0 0 20 20 11 10 10 10 10 10 10 0 5 1 1 1 1 1 1 2 0 0 6 0 0 0 0 0 7 0 7 0 0 0 0 0 0 0 0 0 0 0 0 0 0 0 0 9
0 0 0 0 18 18 11 20 15 20 11 11 10 0 5 1 1 1 1 1 1 2 0 0 0 0 0 0 0 0 0 0 0 0 0 0 0 0 0 0 0 0 0 0 0 0 0 0 0 8
0 0 0 0 11 11 11 16 16 16 16 16 10 0 5 1 1 1 1 1 1 2 0 0 0 0 0 3 3 3 3 3 0 0 0 0 0 6 6 6 6 0 0 0 0 0 0 0 0 9
0 0 0 0 11 16 16 16 16 16 16 16 10 0 5 1 1 1 1 1 1 2 0 0 0 0 0 5 1 1 1 2 0 0 7 0 0 0 6 6 6 0 0 0 0 0 0 0 0 8
0 0 0 0 11 16 16 16 16 16 16 16 10 0 5 1 1 1 1 1 1 2 0 0 0 0 0 5 1 1 1 2 0 0 0 0 7 0 0 0 0 0 0 0 0 0 0 0 0 9
0 0 0 0 11 16 16 12 12 16 16 16 10 0 5 1 1 1 1 1 1 2 0 0 0 0 0 5 1 1 1 2 0 0 0 7 0 0 0 0 0 0 0 0 0 0 0 0 0 8
0 0 0 0 10 10 10 10 10 10 10 10 10 0 5 1 1 1 1 1 1 2 10 10 10 10 10 10 10 1 10 10 10 10 10 0 0 0 0 0 0 0 0 0 0 0 0 14 14 14
1 1 1 1 1 1 1 1 1 1 1 1 1 1 1 1 1 1 1 1 1 1 11 11 11 11 11 1 1 1 1 1 11 11 11 1 1 1 1 1 1 1 1 1 1 1 1 1 1 1
1 1 1 1 1 1 1 1 1 1 1 1 1 1 1 1 1 1 1 1 1 1 11 11 20 11 11 1 1 1 1 1 11 13 11 1 1 1 1 1 1 1 1 1 1 1 1 1 1 1
1 1 1 1 1 1 1 1 1 1 1 1 1 1 1 1 1 1 1 1 1 1 10 10 10 10 10 1 1 1 1 1 10 10 10 1 1 1 1 1 1 1 1 1 1 1 1 1 1 1
1 1 1 1 1 1 1 1 1 1 1 1 1 1 1 1 1 1 1 1 1 1 1 6 0 6 0 1 1 1 1 1 0 6 0 1 1 1 1 1 1 1 1 1 1 1 1 1 1 1
1 1 1 1 1 1 1 1 1 1 1 1 1 1 1 1 1 1 1 1 1 1 1 0 0 0 0 1 1 1 1 1 0 0 0 1 1 1 1 1 1 1 1 1 1 1 1 1 1 1
0 0 0 0 0 0 0 0 0 0 0 0 0 0 0 0 0 0 0 0 0 0 0 0 0 0 0 0 0 0 0 0 0 0 0 0 0 0 0 0 0 0 0 0 0 0 0 0 14 14
0 0 0 0 0 0 0 0 0 0 0 0 0 0 0 0 0 0 0 0 0 0 0 0 0 0 0 0 0 0 0 0 0 0 0 0 0 0 0 0 0 0 0 0 0 0 0 0 0 14
0 0 0 0 0 6 0 0 0 0 0 0 0 0 0 0 0 0 0 0 0 0 0 0 0 0 0 0 0 0 0 0 0 0 0 0 0 0 0 0 0 0 0 0 0 0 0 0 0 0
0 0 0 0 0 0 0 0 0 0 0 0 0 0 0 0 0 0 0 0 0 6 6 0 0 0 0 0 0 0 0 0 0 0 0 0 0 0 0 0 0 0 0 0 0 0 0 0 0 0
0 0 0 0 6 0 0 0 0 0 0 0 0 0 0 0 0 0 0 6 0 0 0 0 6 0 0 0 0 0 0 0 0 0 0 0 0 0 0 0 0 0 0 0 0 0 0 0 0 0